0    ** * ***** 2
 x x*x x x x*x x 
****4 ***** 6*  *
 x x x*x*x*x x x*
 ** *       *   *
 x x*x x x x*x x 
 ** *       *   *
 x x x x x x x x*
****7****** 5*  *
 x x*x x x x*x x 
3****** * ***** 1
